AppName=Indicator Tables Viewer
ErrOccur=error occurred while
DownUpd=downloading updating file
FileCreating=creating file
FileSaved=file saved successfully
UpdateDBDate=update DB correction date
DateUpdated=date updated successfully
SelectTable=select an indicators table for view:
ExportButtonText=export to excel
ChooseFolderButtonText=Choose Folder
SaveSettingsButtonText=save settings
LoginFormTitle=login
Username=username
Password=password
SettingsButtonText=settings
LocalDB=local db
YearDB=year db (qtr. if not)
ErrWhileExtracting=extracting update files
UpdatedSuccessfully=program update downloaded successfully.\nstarting the program.
WhileDeleting=while deleting the
UpdateExists=program update exists
Title=check for updates
LocalDBSettings=local db settings
RemoteDBSettings=remote db settings
DBFileName=db file name:
OtherSettings=other settings
SelectedDirectory=Selected directory:
SettingsTitle=settings
PathToRemoteDB=path to remote DB:
DirForYearDB=dir name for year DB:
DirForQuarterDB=dir name for quarter DB:
InfoTimeout=info messages timeout:
XLSExportPath=XLS export path (program dir if empty):
Version=| program version:
Login=login
Start=start