AppName=Indicator Tables Viewer
ErrOccur=error occurred while
DownUpd=завантаження файлу оновлення
FileCreating=створення файлу
FileSaved=файл успішно збережено
UpdateDBDate=оновлення дати коригування БД
DateUpdated=дата оновлена успішно
SelectTable=виберіть зі списку таблицю для перегляду:
ExportButtonText=експорт в excel
ChooseFolderButtonText=вибір папки
SaveSettingsButtonText=зберегти налаштування
LoginFormTitle=логін
Username=ім'я користувача
Password=пароль
SettingsButtonText=налаштування
LocalDB=локальна БД
YearDB=річна БД (квартальна якщо не вибрано)
ErrWhileExtracting=розпаковки файлів оновлень
UpdatedSuccessfully=оновлення програми успішно завантажено.\nзапуск програми.
WhileDeleting=під час видалення
UpdateExists=наявне оновлення програми
Title=перевірка оновлень
LocalDBSettings=налаштування локальної БД
RemoteDBSettings=налаштування БД на сервері
DBFileName=ім'я файлу БД:
OtherSettings=інші налаштування
SelectedDirectory=Обрана директорія:
SettingsTitle=налаштування
PathToRemoteDB=шлях до БД на сервері:
DirForYearDB=ім'я директорії для річної ДБ:
DirForQuarterDB=ім'я директорії для квартальної ДБ:
InfoTimeout=таймаут показу інфо повідомлень:
XLSExportPath=шлях експорту XLS (директорія програми якщо пусто):
Version=| версія програми:
Login=увійти
Start=запуск
MultiplierSettings=множник роздільної здатності [ширина/висота]